#############################           #############################################
############################               ##########################################
#########################                     #######################################
#######################                              ################################
#####################                                      ##########################
#################                                        ^       ####################
############                                             |         ##################
###########                                              |         ##################
###########                        #####                 |         ##################
###########                       ############          (=)         #################
###########                      ##############          0          #################
##########                      ##############                      #################
##########                              #####                       #################
##########                                                          #################
###########                                                         #################
###########                                                         #################
##############                                                     ##################
#################                                               #####################
##################                                          #########################
######################                     #              ###########################
#######################                    ##           #############################
#####################################################################################
#####################################################################################
#####################################################################################
#####################################################################################