#############################           #############################################
############################               ##########################################
#########################                     #######################################
#######################                              ################################
#####################                                      ##########################
#################                                                ####################
############                                                       ##################
###########                                                        ##################
###########                        #####                           ##################
###########                       ############                      #################
###########                      ##############                     #################
##########                      ##############                      #################
##########                              #####                       #################
##########                                                          #################
###########                                                         #################
###########                                                         #################
##############                                                     ##################
#################                                               #####################
##################                                          #########################
######################                     #              ###########################
#######################                    ##           #############################
#####################################################################################
#####################################################################################
#####################################################################################
#####################################################################################